{
    "Name": "Level 8",
    "Difficulty": "medium",
    "Size": "9",
    "Board": [
        [0,1,0,5,2,8,3,7,0],
        [5,0,7,0,0,0,9,0,2],
        [3,0,0,0,0,0,0,0,5],
        [0,0,0,0,0,9,0,4,3],
        [1,9,8,3,4,0,0,5,7],
        [4,0,0,0,5,6,8,1,0],
        [0,0,0,0,0,0,5,3,1],
        [9,0,4,6,0,5,0,0,8],
        [0,0,0,2,7,0,0,0,0]
    ]
}