{
    "Name": "Level 9",
    "Difficulty": "medium",
    "Size": "9",
    "Board": [
        [0,0,0,0,0,0,9,6,1],
        [0,3,9,6,0,7,2,0,5],
        [6,5,1,0,0,0,0,0,4],
        [2,7,0,3,6,8,5,0,9],
        [0,0,0,0,0,0,6,2,8],
        [0,8,6,2,9,1,0,4,0],
        [0,0,8,9,5,0,0,0,6],
        [0,4,0,0,0,0,0,9,2],
        [0,0,0,7,0,4,0,5,0]
    ]
}