{
    "Name": "Level 7",
    "Difficulty": "medium",
    "Size": "9",
    "Board": [
        [2,6,1,7,3,0,0,0,0],
        [8,0,9,2,0,1,3,0,7],
        [7,5,3,0,0,0,2,0,0],
        [0,0,0,4,0,0,8,0,0],
        [0,0,4,1,0,5,0,3,0],
        [3,8,0,6,2,0,0,4,0],
        [6,7,0,0,4,0,9,0,3],
        [1,0,0,0,9,0,5,7,0],
        [4,9,0,0,0,0,0,2,0]
    ]
}