{
    "Name": "Level 2",
    "Difficulty": "easy",
    "Size": "9",
    "Board": [
        [0,4,0,9,1,0,7,3,2],
        [7,0,9,3,8,6,1,0,0],
        [3,0,0,0,0,0,6,8,9],
        [1,7,4,6,5,8,2,9,3],
        [0,3,2,1,0,9,0,0,0],
        [0,0,6,7,2,3,4,1,8],
        [0,8,7,4,9,0,0,0,0],
        [0,9,3,5,0,0,0,0,7],
        [2,6,0,0,3,7,0,5,4]
    ]
}