{
    "Name": "Level 5",
    "Difficulty": "easy",
    "Size": "9",
    "Board": [
        [6,3,0,5,2,0,7,1,0],
        [0,0,0,0,0,8,4,0,6],
        [5,0,0,0,6,9,0,0,3],
        [1,0,9,0,8,0,0,0,0],
        [8,4,0,0,0,1,6,0,5],
        [0,0,7,9,0,6,0,0,0],
        [0,0,0,0,0,0,5,7,4],
        [0,7,5,0,0,3,8,6,0],
        [0,0,0,8,5,7,0,3,1]
    ]
}