{
    "Name": "Level 1",
    "Difficulty": "easy",
    "Size": "9",
    "Board": [
        [0,3,4,0,7,0,0,1,0],
        [6,0,0,1,9,0,3,4,8],
        [0,9,8,0,0,2,5,6,7],
        [8,5,0,7,6,1,0,2,3],
        [4,2,6,8,5,3,7,9,1],
        [0,1,0,9,2,4,8,5,0],
        [9,0,1,0,3,0,2,8,4],
        [0,0,7,4,0,9,6,3,5],
        [0,0,5,2,8,6,0,7,9]
    ]
}