{
    "Name": "Level 11",
    "Difficulty": "hard",
    "Size": "9",
    "Board": [
        [5,0,7,8,4,0,0,0,0],
        [0,0,2,0,0,0,0,7,0],
        [0,0,0,7,0,5,3,0,0],
        [0,1,4,0,2,0,7,0,0],
        [2,0,0,0,0,0,0,0,8],
        [0,0,8,0,5,0,1,4,0],
        [0,0,3,5,0,7,0,0,0],
        [0,6,0,0,0,0,5,0,0],
        [0,0,0,0,9,6,2,0,7]
    ]
}