{
    "Name": "Level 15",
    "Difficulty": "hard",
    "Size": "9",
    "Board": [
        [0,0,0,0,6,8,0,0,0],
        [0,0,9,5,1,0,0,7,0],
        [8,5,1,0,0,4,0,0,0],
        [0,1,0,0,7,0,0,0,5],
        [6,0,0,0,0,0,0,0,9],
        [5,0,0,0,2,0,0,4,0],
        [0,0,0,6,0,0,7,5,2],
        [0,2,0,0,8,7,6,0,0],
        [0,0,0,2,3,0,0,0,0]
    ]
}