{
    "Name": "Level 4",
    "Difficulty": "easy",
    "Size": "9",
    "Board": [
        [0,8,0,0,0,0,4,0,0],
        [0,7,0,9,0,3,0,1,2],
        [1,2,9,0,8,0,0,0,7],
        [0,0,0,4,3,8,0,0,0],
        [0,4,8,6,5,1,7,2,0],
        [5,0,3,0,0,7,1,8,0],
        [0,0,0,0,0,0,9,7,8],
        [8,5,7,0,0,0,0,0,0],
        [2,9,1,0,0,6,3,0,0]
    ]
}