{
    "Name": "Level 10",
    "Difficulty": "medium",
    "Size": "9",
    "Board": [
        [0,0,1,8,7,0,0,0,0],
        [0,0,0,0,0,1,3,0,2],
        [0,0,0,3,9,0,0,0,7],
        [0,9,0,0,0,8,0,1,5],
        [7,0,0,1,0,5,0,0,9],
        [3,1,0,9,0,0,0,6,0],
        [5,0,0,0,0,7,0,0,0],
        [6,0,2,5,0,0,0,0,0],
        [0,0,0,0,8,9,5,0,0]
    ]
}