{
    "Name": "Level 12",
    "Difficulty": "hard",
    "Size": "9",
    "Board": [
        [0,0,8,6,0,0,0,0,9],
        [4,7,0,3,0,0,0,0,0],
        [0,0,0,0,0,0,4,1,3],
        [0,0,0,0,8,4,7,0,0],
        [7,0,0,1,0,6,0,0,2],
        [0,0,6,7,9,0,0,0,0],
        [1,9,7,0,0,0,0,0,0],
        [0,0,0,0,0,3,0,2,7],
        [2,0,0,0,0,1,8,0,0]
    ]
}